17 23
40 628
240 100
1 1 1 1 1 1 1 1 1 1 1 1 1 1 1 1 1 1 1 1 1 1 1 
1 1 1 1 10 0 0 0 0 0 0 0 0 0 0 0 0 0 0 1 1 1 1 
1 1 1 1 10 0 0 0 0 0 0 0 2 0 2 0 2 0 0 0 0 1 1 
1 1 1 1 1 1 1 1 1 1 4 0 0 0 0 0 0 0 0 0 1 1 1 
1 1 1 1 1 1 0 0 1 1 4 0 0 0 0 0 0 0 1 1 1 1 1 
1 1 1 1 0 0 0 0 1 1 4 0 0 0 0 1 1 1 1 1 1 1 1 
1 1 1 0 0 0 0 0 0 1 4 0 0 1 1 1 1 1 1 1 1 1 1 
1 1 1 0 0 0 2 0 0 1 1 0 0 0 0 0 0 0 0 0 0 5 1 
1 1 1 0 0 0 1 0 0 1 1 1 1 0 0 0 0 0 0 0 0 5 1 
1 1 1 1 0 0 1 0 0 0 0 0 1 1 1 1 0 0 0 0 0 5 1 
1 1 1 1 7 7 1 0 0 0 0 0 0 0 0 0 0 0 0 0 0 5 1 
1 1 1 1 0 0 1 0 0 0 0 0 0 0 0 0 0 0 0 0 0 5 1 
9 0 0 1 0 0 1 0 0 0 1 1 0 0 0 0 0 0 0 1 1 1 1 
9 0 0 0 0 0 1 2 2 2 1 1 0 0 0 0 0 0 0 1 1 1 1 
1 1 1 1 1 1 1 1 1 1 1 1 0 0 1 1 0 0 0 1 1 1 1 
1 1 1 1 1 1 1 1 1 1 1 1 2 2 1 1 2 2 2 1 1 1 1 
1 1 1 1 1 1 1 1 1 1 1 1 1 1 1 1 1 1 1 1 1 1 1 