14 14
574 484
52 101
1 1 1 1 1 1 1 1 1 1 1 1 1 1
10 0 0 0 0 1 0 0 1 1 1 1 1 1
10 0 0 0 0 1 0 0 0 0 1 1 1 1
1 1 0 0 0 1 0 0 0 0 1 1 1 1
1 1 0 0 0 1 0 0 0 0 0 1 1 1
1 1 0 0 0 1 0 0 0 0 0 1 1 1
1 1 0 0 0 1 0 0 0 0 0 0 1 1
1 1 0 0 0 1 0 0 0 0 0 0 1 1
1 1 0 0 0 1 0 0 0 0 0 0 0 9
1 1 0 0 0 1 0 0 0 0 0 0 0 9
1 1 0 0 0 0 0 0 0 0 0 0 0 9
1 1 0 0 1 1 1 1 1 1 1 1 1 1 
1 1 2 2 1 1 1 1 1 1 1 1 1 1
1 1 1 1 1 1 1 1 1 1 1 1 1 1