15 28
1242 577
1112 97
1 1 1 1 1 1 1 1 1 1 1 1 1 1 1 1 1 1 1 1 1 1 10 10 1 1 1 1
1 1 1 1 1 1 1 1 1 1 1 1 1 3 3 1 1 1 1 1 1 1 0 0 1 1 1 1
1 1 1 1 1 1 1 1 1 1 1 1 1 4 0 0 0 0 0 0 0 0 0 0 1 1 1 1
1 1 1 1 1 1 1 1 1 1 1 1 1 1 0 0 0 0 0 0 2 0 0 1 1 1 1 1
1 1 1 1 1 1 1 1 1 0 0 1 1 1 0 0 0 5 1 1 1 1 1 1 1 1 1 1
1 1 1 1 1 1 1 0 0 0 0 1 1 1 0 0 0 5 1 0 0 0 0 1 1 1 1 1
1 1 1 1 1 1 0 0 0 0 0 5 1 1 0 0 0 1 1 0 0 0 0 1 1 1 1 1
1 1 1 1 1 4 0 0 0 1 0 5 1 4 0 0 0 1 1 0 0 0 0 0 1 1 1 1
1 1 1 1 1 4 0 0 0 1 0 5 1 4 0 0 5 1 1 0 1 1 0 0 1 1 1 1
1 1 1 1 1 4 0 0 1 1 0 0 0 0 0 0 1 1 0 0 0 1 0 0 0 0 1 1
1 1 1 1 0 0 0 1 1 1 1 1 1 1 1 1 1 1 0 0 0 0 0 0 0 0 0 9
1 1 1 1 0 0 0 0 0 0 0 0 0 0 0 0 0 0 0 0 0 0 0 0 0 0 0 9
1 1 1 1 1 0 0 0 0 0 0 0 0 0 0 2 2 0 0 0 1 1 1 1 0 0 0 9
1 1 1 1 1 1 1 1 1 1 4 0 0 0 1 1 1 1 1 1 1 1 1 1 1 1 1 1
1 1 1 1 1 1 1 1 1 1 1 1 1 1 1 1 1 1 1 1 1 1 1 1 1 1 1 1
