21 35
48 768
1584 384
1 1 1 1 1 1 1 1 1 1 1 1 1 1 1 1 1 1 1 1 1 1 1 1 1 1 1 1 1 1 1 1 1 1 1
1 1 1 1 1 1 1 1 1 1 1 1 3 3 3 1 1 1 1 1 1 1 1 1 1 1 1 1 1 1 1 1 1 1 1
1 1 1 1 1 1 1 1 1 1 1 4 0 0 0 5 1 1 1 1 1 1 1 1 1 1 1 1 1 1 1 1 1 1 1
1 1 1 1 1 1 1 1 1 1 1 4 0 0 0 0 3 3 3 1 1 1 1 1 1 1 1 1 1 1 1 1 1 1 1
1 1 1 1 1 1 1 1 1 1 1 4 0 0 0 0 0 0 0 1 1 1 1 1 1 1 1 1 1 1 1 1 1 1 1
1 1 1 1 1 1 1 1 1 1 1 4 0 0 0 0 0 0 0 1 1 1 1 1 1 1 1 1 1 1 0 0 0 1 1
1 1 1 1 1 1 1 1 1 1 1 4 0 0 0 2 0 0 0 5 1 1 1 1 1 1 1 1 1 1 0 0 0 0 10
1 1 1 1 1 1 1 1 1 1 1 4 0 0 0 1 4 0 0 5 1 1 1 1 1 1 1 1 1 1 0 0 0 0 10
1 1 1 1 1 1 1 1 1 1 1 4 0 0 0 1 4 0 7 0 0 0 0 0 0 0 1 1 1 1 0 0 0 0 10
1 1 1 1 1 1 1 1 1 1 1 4 6 0 0 1 4 0 0 0 0 0 0 7 0 0 0 0 0 0 0 0 1 1 1
1 1 1 1 1 1 1 1 1 1 1 2 1 4 7 1 1 2 2 2 2 2 0 0 0 0 0 0 7 0 0 0 1 1 1
1 0 0 0 0 0 0 0 0 1 1 1 1 4 0 1 1 1 1 1 1 1 2 2 2 2 2 0 0 0 0 0 1 1 1
1 0 7 0 0 0 0 0 0 1 1 1 1 4 0 0 0 0 0 0 5 1 1 1 1 1 1 2 2 2 2 1 1 1 1
1 0 0 0 0 2 0 0 0 1 1 1 1 4 7 0 0 0 0 0 5 1 1 1 1 1 1 1 1 1 1 1 1 1 1
1 0 0 0 5 1 4 0 0 0 0 0 1 4 0 0 0 0 0 0 5 1 1 1 1 1 1 1 1 1 1 1 1 1 1
9 0 0 0 5 1 4 0 0 0 0 0 1 4 0 0 0 0 0 0 5 1 1 1 1 1 1 1 1 1 1 1 1 1 1
9 0 0 0 5 1 4 0 0 0 0 0 3 3 3 3 3 0 0 0 5 1 1 1 1 1 1 1 1 1 1 1 1 1 1
9 0 0 0 0 3 0 0 0 0 0 0 0 0 0 0 0 0 0 0 5 1 1 1 1 1 1 1 1 1 1 1 1 1 1
1 1 1 0 0 0 0 0 1 1 1 1 2 2 2 2 2 0 6 0 5 1 1 1 1 1 1 1 1 1 1 1 1 1 1
1 1 1 0 0 0 0 0 1 1 1 1 1 1 1 1 1 0 1 0 5 1 1 1 1 1 1 1 1 1 1 1 1 1 1
1 1 1 2 2 2 2 2 1 1 1 1 1 1 1 1 1 2 1 2 5 1 1 1 1 1 1 1 1 1 1 1 1 1 1